+--+--+--+--+--+--+--+--+--+--+
   |           |     |     |  |
+  +--+--+  +--+  +  +--+  +  +
|  |        |     |        |  |
+  +  +  +--+  +  +--+--+--+  +
|     |        |           |  |
+  +--+--+  +--+--+--+--+  +  +
|  |     |     |     |  |     |
+  +--+  +--+  +--+  +  +--+  +
|        |     |     |     |  |
+--+--+--+  +--+  +--+--+  +  +
|        |  |     |     |  |  |
+  +--+  +  +  +--+--+  +  +  +
|  |  |     |  |     |  |  |  |
+  +  +--+--+  +  +  +  +  +  +
|  |     |     |  |     |  |  |
+  +  +  +  +--+  +--+--+  +--+
|  |  |  |     |  |     |     |
+  +  +  +  +  +  +  +  +--+  +
|     |     |        |         
+--+--+--+--+--+--+--+--+--+--+
