+--+--+--+--+--+--+--+--+--+--+--+--+--+--+--+--+--+--+--+--+--+--+--+--+--+--+--+--+--+--+--+--+--+--+--+--+--+--+--+--+
   |     |  |           |     |              |           |  |        |     |        |                    |              |
+  +  +  +  +  +--+--+  +  +  +  +--+--+--+  +  +--+--+  +  +  +--+  +  +  +  +  +--+  +--+--+--+--+--+  +  +--+--+--+  +
|     |  |     |     |     |     |           |        |        |     |  |  |  |     |     |           |  |  |  |        |
+--+--+  +--+  +  +  +--+--+--+--+  +--+--+--+--+  +--+--+--+--+  +--+--+  +  +--+  +--+  +  +--+--+  +  +  +  +  +--+--+
|     |  |  |  |  |        |        |     |     |           |  |  |     |  |  |     |     |  |        |  |     |        |
+  +  +  +  +  +  +--+--+  +  +--+--+  +  +  +  +--+--+--+  +  +  +  +  +  +  +  +--+--+--+  +  +--+--+  +--+--+--+--+  +
|  |     |  |  |        |  |  |  |     |     |     |        |  |     |     |  |        |     |  |  |                 |  |
+  +--+--+  +  +--+--+  +--+  +  +  +--+--+--+  +--+  +  +--+  +  +--+--+  +  +--+  +  +  +--+  +  +  +--+--+  +--+--+  +
|  |           |     |     |        |  |        |     |     |     |     |     |     |  |  |  |     |        |  |  |     |
+  +--+  +--+  +  +  +--+  +--+  +  +  +  +--+--+  +--+--+--+--+--+  +  +--+--+--+--+  +  +  +--+  +--+--+--+  +  +  +  +
|        |     |  |  |  |        |  |     |     |  |           |     |     |           |     |              |  |     |  |
+--+--+--+  +--+  +  +  +--+--+--+  +--+--+--+  +  +  +--+--+  +  +--+--+  +  +--+--+--+--+--+--+  +--+--+  +  +  +--+--+
|           |     |     |     |  |  |  |     |  |     |        |     |  |  |        |              |     |  |  |        |
+  +--+--+--+  +--+--+--+  +  +  +  +  +  +  +  +  +--+  +--+--+--+  +  +  +--+--+  +  +--+--+--+--+  +--+  +  +--+--+  +
|  |        |  |           |  |        |  |           |  |     |     |  |        |     |              |     |  |        |
+  +  +--+  +  +--+--+--+  +  +--+  +  +--+--+  +--+--+  +  +  +--+--+  +--+--+  +--+--+  +  +--+  +--+  +--+  +--+--+  +
|     |     |     |     |  |  |     |           |           |     |                 |     |     |  |  |     |     |     |
+  +--+  +--+  +  +--+  +--+  +  +--+--+--+  +--+  +--+  +--+--+  +  +--+--+--+--+  +  +--+--+  +  +  +--+  +  +  +--+  +
|     |        |  |     |     |  |        |  |  |     |  |     |     |           |  |  |        |  |        |  |  |     |
+--+  +--+--+--+  +  +--+  +--+  +  +--+  +  +  +  +  +  +  +  +  +--+  +--+--+  +--+  +  +--+--+  +--+--+  +--+  +  +--+
|  |  |           |     |     |  |     |  |     |  |  |  |  |  |  |     |     |  |     |  |     |           |     |  |  |
+  +  +  +--+--+--+--+  +--+  +--+  +  +  +--+--+--+  +  +--+  +--+  +--+  +  +  +  +--+  +  +  +--+--+--+--+  +  +  +  +
|     |     |        |  |           |  |  |           |              |     |  |  |     |     |  |              |        |
+--+--+--+  +  +--+  +  +  +  +--+--+  +  +  +--+--+--+--+--+  +--+--+  +--+  +  +--+  +--+--+  +  +--+  +--+--+--+--+  +
|        |  |  |        |  |  |     |  |  |  |        |     |        |  |  |  |  |  |        |     |  |     |           |
+  +  +--+  +  +  +--+--+  +  +  +--+  +--+  +  +--+--+  +  +--+--+  +  +  +  +  +  +  +--+  +--+--+  +--+  +--+--+--+--+
|  |     |  |  |        |  |  |              |           |           |     |  |  |  |  |     |     |        |     |     |
+  +--+  +  +  +--+--+  +  +  +--+--+--+--+--+--+--+--+--+--+  +--+--+--+--+  +  +  +  +  +--+  +  +--+--+--+  +  +  +--+
|     |     |  |     |     |              |              |              |  |     |     |        |     |        |        |
+--+  +--+--+  +  +  +--+--+--+--+--+--+  +  +--+--+--+  +--+  +  +--+  +  +--+--+--+--+--+--+--+--+  +  +--+--+--+  +  +
|  |  |     |  |  |  |           |  |     |     |     |  |     |     |  |           |  |           |     |           |  |
+  +  +  +--+  +  +  +  +--+--+  +  +  +--+--+  +  +--+  +  +--+--+  +  +--+--+--+  +  +  +--+--+--+--+--+--+  +--+--+  +
|  |  |  |     |  |  |  |     |  |        |     |  |     |  |        |  |     |     |  |        |     |  |     |     |  |
+  +  +  +  +--+  +  +  +  +  +  +--+  +  +--+--+  +  +--+--+  +--+--+  +--+  +  +--+  +--+--+  +  +  +  +  +--+--+  +  +
|  |  |  |     |  |     |  |  |  |     |        |  |           |           |  |  |     |     |     |  |           |  |  |
+  +  +  +--+  +  +--+  +  +--+  +  +--+--+--+  +  +--+--+--+--+  +--+--+  +  +  +  +--+  +  +--+--+  +--+--+  +  +  +  +
|     |  |     |     |  |           |           |  |           |  |     |           |     |  |     |           |  |  |  |
+--+--+  +  +--+--+  +  +--+--+--+--+  +--+--+--+  +  +--+  +  +  +  +--+--+--+  +--+  +--+  +  +  +--+--+--+--+  +  +  +
|        |  |  |     |     |     |              |  |  |     |  |  |        |           |     |  |  |           |     |  |
+  +--+--+  +  +  +--+--+--+  +  +--+  +--+--+  +  +--+  +--+  +--+--+--+  +  +  +--+--+  +  +  +--+  +--+--+  +--+--+  +
|  |     |     |     |     |  |     |  |     |  |  |     |        |     |     |     |     |     |     |  |           |  |
+  +  +--+--+  +--+  +  +  +  +--+  +  +  +  +  +  +  +--+--+  +  +  +  +--+--+--+  +--+--+--+--+  +--+  +  +--+--+  +  +
|     |     |  |        |     |  |  |     |  |     |     |     |     |  |        |     |     |  |  |  |     |        |  |
+--+  +  +  +  +--+--+--+--+--+  +  +--+  +  +--+--+--+  +  +--+--+--+  +  +--+--+--+  +  +  +  +  +  +--+--+--+--+--+  +
|  |     |           |     |  |  |  |     |              |     |        |              |  |  |     |  |        |        |
+  +--+--+--+  +--+  +  +  +  +  +  +--+--+  +--+--+--+--+--+  +--+--+--+  +--+--+--+--+--+  +  +--+  +  +--+  +--+  +--+
|  |     |        |  |  |  |  |  |     |     |  |           |  |     |     |                    |     |  |  |        |  |
+  +  +  +  +--+--+  +  +  +  +  +--+  +  +--+  +  +--+--+--+  +  +  +  +--+  +--+--+--+--+  +--+--+  +  +  +--+--+--+  +
|     |  |        |     |  |  |     |  |  |  |  |              |  |  |     |  |     |     |  |     |     |           |  |
+  +--+--+--+--+  +--+--+  +  +--+  +  +  +  +  +--+--+--+--+--+--+  +--+  +  +  +  +  +  +  +  +  +--+--+  +--+--+  +  +
|  |              |        |  |  |  |  |  |     |  |           |     |        |  |     |  |  |  |     |     |        |  |
+  +  +--+--+--+--+  +  +--+  +  +  +  +  +  +--+  +  +--+--+  +  +--+  +  +--+  +--+--+  +  +  +--+  +  +--+  +--+--+  +
|  |     |     |     |  |        |     |           |        |  |  |     |  |  |     |  |     |  |  |  |     |     |     |
+  +--+  +  +  +--+--+  +  +  +--+--+--+--+--+--+--+--+--+  +  +  +  +--+  +  +--+  +  +--+--+  +  +  +--+  +--+  +--+  +
|  |     |  |        |  |  |  |        |                    |     |  |     |                 |     |  |     |  |        |
+  +  +--+  +--+--+  +  +  +  +  +--+  +  +--+--+--+--+--+--+--+--+  +  +--+--+--+--+--+--+--+--+--+  +  +--+  +--+--+  +
|  |     |        |     |  |        |  |           |              |  |  |     |                    |        |        |  |
+  +--+  +--+--+  +--+--+  +--+--+  +--+--+--+--+  +--+  +--+--+  +  +  +--+  +  +--+--+--+--+--+  +  +  +  +--+--+  +  +
|     |     |  |  |        |     |  |           |     |  |  |     |  |  |     |     |     |  |     |  |  |           |  |
+  +--+--+  +  +  +  +--+--+  +  +  +  +--+--+  +--+  +  +  +  +--+  +  +  +--+--+  +  +  +  +  +--+  +--+--+--+--+--+  +
|           |     |     |     |  |  |  |           |  |     |  |     |  |        |     |     |     |           |     |  |
+--+--+--+  +--+--+--+  +  +--+  +  +  +  +  +--+--+  +--+--+  +  +--+  +--+  +  +--+--+--+--+--+  +--+  +--+--+  +  +--+
|     |  |     |     |  |  |     |  |  |  |  |        |        |     |  |  |  |  |     |     |     |           |  |     |
+  +  +  +--+  +  +--+  +  +  +--+  +  +  +  +  +--+--+  +--+--+--+  +  +  +  +  +  +--+  +  +  +--+  +--+--+  +  +--+  +
|  |  |     |  |  |     |  |  |     |  |  |     |           |        |     |  |  |        |  |     |     |     |  |     |
+  +  +--+  +  +  +  +--+  +--+  +--+  +  +  +--+--+--+  +  +  +--+--+--+  +  +  +--+--+  +  +--+  +--+  +  +--+  +  +--+
|  |  |           |     |     |  |     |  |  |        |  |  |           |  |  |  |        |     |  |     |     |  |     |
+  +  +  +--+--+--+--+  +--+  +  +--+--+  +  +  +--+  +  +  +--+--+--+  +  +  +  +--+--+--+  +--+  +  +--+--+  +  +--+  +
|  |     |        |  |  |  |     |     |  |  |     |  |  |        |     |     |        |     |     |     |     |     |  |
+  +--+--+  +--+  +  +  +  +--+--+  +  +  +  +--+--+  +--+--+--+  +  +--+--+--+--+--+  +  +--+  +--+--+  +  +--+--+  +--+
|        |     |           |        |  |  |        |           |  |  |     |        |     |     |        |     |        |
+--+--+  +--+  +--+--+  +--+  +--+--+  +  +  +--+  +  +--+--+  +  +  +  +  +  +--+  +--+--+  +--+  +--+--+--+  +--+--+  +
|     |     |  |     |     |     |  |     |  |     |  |     |  |  |  |  |  |     |              |  |  |     |        |  |
+  +--+--+  +  +  +  +--+  +--+  +  +--+--+--+  +  +  +  +  +  +  +  +--+  +--+  +--+  +--+--+  +  +  +  +--+--+--+  +  +
|        |     |  |     |        |           |  |     |  |  |     |        |     |     |        |  |  |     |        |  |
+  +--+  +  +--+--+  +  +--+--+--+--+--+--+  +  +--+--+  +--+--+--+--+  +--+--+  +  +--+--+--+--+  +  +--+  +--+  +--+  +
|  |  |  |        |  |        |        |                 |        |     |        |                 |  |           |     |
+  +  +  +--+--+  +  +--+--+  +  +--+  +  +  +--+--+--+--+  +--+  +  +--+  +--+--+--+  +--+--+--+--+  +  +  +--+--+  +  +
|     |              |        |     |     |                 |     |        |           |                 |           |   
+--+--+--+--+--+--+--+--+--+--+--+--+--+--+--+--+--+--+--+--+--+--+--+--+--+--+--+--+--+--+--+--+--+--+--+--+--+--+--+--+
