+--+--+--+--+--+--+--+--+--+--+--+--+--+--+--+--+--+--+--+--+--+--+--+--+--+
            |  |                 |     |                    |     |     |  |
+--+--+--+  +  +  +--+--+  +--+  +--+  +--+  +--+--+--+  +  +  +--+  +  +  +
|              |     |     |  |  |     |     |        |  |  |  |     |  |  |
+  +--+--+--+--+--+  +--+--+  +  +  +--+  +--+  +--+  +--+  +  +  +--+  +  +
|  |              |     |     |  |  |  |     |  |  |     |     |  |     |  |
+  +--+--+  +--+  +--+  +  +--+  +  +  +  +  +  +  +--+  +--+  +  +  +--+  +
|        |  |     |     |        |  |     |  |     |  |     |  |  |     |  |
+--+--+  +  +  +--+  +--+  +--+  +  +--+--+  +--+--+  +--+  +  +  +--+  +  +
|        |  |     |     |  |     |     |     |     |  |        |  |  |  |  |
+  +--+--+  +--+  +--+  +  +--+--+--+  +  +--+  +  +  +--+  +--+  +  +  +  +
|  |        |  |     |  |                 |     |  |     |  |     |  |     |
+  +  +--+--+  +--+  +  +--+--+--+--+  +--+  +--+  +--+  +  +  +--+  +--+--+
|     |     |  |  |     |           |     |     |        |  |  |        |  |
+  +--+  +  +  +  +--+--+  +--+--+  +--+  +--+--+--+  +--+--+  +  +--+  +  +
|  |     |     |        |  |     |        |  |     |  |     |  |  |        |
+  +  +--+--+--+  +--+  +  +--+  +--+--+--+  +  +  +  +  +  +  +  +  +--+--+
|     |  |           |  |     |  |        |     |        |  |     |        |
+--+--+  +  +--+--+--+  +--+  +  +  +  +--+--+  +--+  +--+--+  +--+--+--+  +
|        |  |        |     |  |  |  |        |  |     |     |     |        |
+  +--+  +  +  +--+  +--+  +  +  +  +--+  +--+  +  +--+  +  +--+  +  +--+--+
|  |  |  |        |     |  |     |     |        |     |  |     |  |        |
+  +  +  +--+  +  +--+  +--+  +--+--+  +--+--+--+--+  +  +--+  +  +--+--+  +
|  |  |     |  |  |  |        |     |  |              |     |  |  |  |     |
+  +  +--+  +  +  +  +--+--+--+--+  +  +--+--+  +--+--+  +  +  +  +  +  +--+
|     |  |  |  |  |        |     |     |        |     |  |  |  |  |        |
+--+--+  +  +  +  +--+--+  +  +  +  +--+  +--+  +  +  +  +--+  +  +--+--+  +
|     |  |     |        |  |  |  |  |        |  |  |  |     |     |     |  |
+  +  +  +--+--+--+--+  +  +  +  +  +  +--+  +--+  +  +--+  +--+--+--+  +  +
|  |  |        |           |  |     |     |        |     |        |     |  |
+  +  +  +--+  +--+--+  +  +  +--+--+--+  +--+--+--+--+--+  +--+--+  +--+--+
|  |  |     |           |              |     |           |  |     |  |     |
+  +  +--+  +--+--+  +--+--+--+--+--+  +--+  +  +--+--+  +  +  +  +  +  +  +
|  |     |  |     |  |        |        |     |  |        |  |  |     |  |  |
+  +--+  +  +  +  +  +--+--+  +  +--+--+  +--+  +  +--+--+  +  +  +--+  +  +
|  |  |     |  |  |        |     |     |  |     |  |     |  |  |  |     |  |
+  +  +--+--+  +--+--+  +--+--+--+  +  +  +  +  +  +  +  +  +--+  +  +--+  +
|  |        |        |     |  |     |     |  |  |     |     |     |  |     |
+  +--+--+  +  +--+  +  +  +  +  +--+--+--+  +  +--+--+--+--+  +--+  +  +--+
|           |  |     |  |     |              |                 |     |     |
+--+--+--+--+  +  +--+--+--+  +--+--+--+  +--+--+--+--+--+--+--+  +--+--+  +
|  |        |  |              |           |     |     |        |  |     |  |
+  +  +--+  +  +--+--+--+--+--+--+  +--+--+  +  +  +  +  +--+--+  +  +--+  +
|     |     |  |        |  |                 |  |  |              |        |
+--+--+--+  +  +  +--+  +  +  +  +  +--+  +--+  +  +--+--+--+--+  +  +--+--+
|        |        |     |     |  |  |     |  |  |     |        |  |        |
+  +--+  +--+--+--+  +--+--+--+--+  +  +--+  +  +--+  +--+--+  +--+--+--+  +
|     |        |     |  |        |  |     |     |     |           |        |
+--+  +--+  +  +  +--+  +  +--+  +--+--+  +  +--+  +--+  +--+--+  +  +--+--+
|     |     |     |        |              |              |        |         
+--+--+--+--+--+--+--+--+--+--+--+--+--+--+--+--+--+--+--+--+--+--+--+--+--+
