+--+--+--+--+--+--+--+--+--+--+
      |        |        |     |
+  +  +  +--+  +--+--+  +  +--+
|  |     |  |  |     |  |     |
+  +--+--+  +  +  +  +  +--+  +
|        |     |  |        |  |
+  +--+--+--+--+--+  +--+--+  +
|        |  |     |  |     |  |
+--+--+  +  +  +  +  +  +  +  +
|        |     |  |  |  |     |
+  +--+--+--+--+  +  +  +--+  +
|  |                 |     |  |
+  +--+--+--+--+  +--+  +  +  +
|           |     |     |  |  |
+--+--+--+  +  +--+--+--+  +  +
|           |  |  |        |  |
+  +--+  +--+  +  +  +--+--+  +
|     |           |  |     |  |
+--+  +--+--+--+--+  +  +  +  +
|                    |  |      
+--+--+--+--+--+--+--+--+--+--+
